# added postag entries
#-------------------------------------------------------------------------------
# Do not add words here, but report them to languagetool@taaltik.nl
#-------------------------------------------------------------------------------
achtmaal	achtmaal	BYW
bijkans	bijkans	BYW
dankzij	dankzij	VRZ
driemaal	driemaal	BYW
drone	drone	ZNW:EKV:DE_
duizendmaal	duizendmaal	BYW
elfmaal	elfmaal	BYW
erachter	erachter	BYW
gisteravond	gisteravond	BYW
gisterenmorgen	gisterenmorgen	BYW
gistermorgen	gistermorgen	BYW
helaas	helaas	BYW
honderdmaal	honderdmaal	BYW
ietwat	ietwat	BYW
ja	ja	TSW
moving	moving	BNW:STL:ONV
nee	nee	TSW
negenmaal	negenmaal	BYW
och	och	TSW
oftewel	oftewel	VGW
sambel	sambel	ZNW:EKV:DE_
sorry	sorry	TSW
sparrenhouten	sparrenhouten	BNW:STF
tegelijkertijd	tegelijkertijd	BYW
tegenover	tegenover	BYW
tienmaal	tienmaal	BYW
tussendoor	tussendoor	BYW
twaalfmaal	twaalfmaal	BYW
tweemaal	tweemaal	BYW
vanmorgen	vanmorgen	BYW
viermaal	viermaal	BYW
vijfmaal	vijfmaal	BYW
vrijwel	vrijwel	BYW
waarvoor	waarvoor	BYW
zesmaal	zesmaal	BYW
zevenmaal	zevenmaal	BYW
zoiets	zoiets	VNW:OBP
Esperanto	Esperanto	ZNW:EKV:HET
Boogschutter	Boogschutter	ZNW:EKV:DE_
Luilekkerland	Luilekkerland	ZNW:EKV:HET
hôtelier	hôtelier	ZNW:EKV:DE_
brugslag	brugslag	ZNW:EKV:DE_
herkauwgedrag	herkauwgedrag	ZNW:EKV:HET
grammaticaprobleem	grammaticaprobleem	ZNW:EKV:HET
grammaticaproblemen	grammaticaprobleem	ZNW:MRV:DE_
slotanalyses	slotanalyse	ZNW:MRV:DE_
penisvergrotingsapparaat	penisvergrotingsapparaat	ZNW:EKV:HET
informatie-uitwisseling	informatie-uitwisseling	ZNW:EKV:DE_
Mongool	Mongool	ZNW:EKV:DE_
zakenduo	zakenduo	ZNW:EKV
zakenduo's	zakenduo	ZNW:MRV:DE_
joik	joik	ZNW:EKV:DE_
aanvalsdrone	aanvalsdrone	ZNW:EKV:DE_
Houthi	Houthi	ZNW:EKV:DE_
Houthi's	Houthi	ZNW:MRV:DE_
Houthirebellen	Houthirebel	ZNW:MRV:DE_
tepanyaki	tepanyaki	ZNW:EKV
yakitori	yakitori	ZNW:EKV
informatie-uitwisselingen	informatie-uitwisseling	ZNW:MRV:DE_
Mongolen	Mongool	ZNW:MRV:DE_
Mongools	Mongools	BNW:STL:ONV
Mongoolse	Mongools	BNW:STL:VRB
Mongoolse	Mongoolse	ZNW:EKV:DE_
wandelwegjes	wandelweg	ZNW:MRV:VRK:DE_
opbrengstgerichter	opbrengstgericht	BNW:VGR:ONV
terugrij	terugrijden	WKW:TGW:1EP
kunststof	kunststof	BNW:STF
heve	heve	ZNW:EKV:DE_
heven	heve	ZNW:MRV:DE_
niets	niets	VNW:OBP
tweetakts	tweetakt	ZNW:MRV:DE_
tweetakten	tweetakt	ZNW:MRV:DE_
gaspen	gaspen	WKW:TGW:INF
gasp	gaspen	WKW:TGW:1EP
gaspend	gaspen	WKW:ODW:ONV
gaspende	gaspen	WKW:ODW:VRB
gaspt	gaspen	WKW:TGW:3EP
vlooier	vlooier	ZNW:EKV:DE_
vlooiers	vlooier	ZNW:MRV:DE_
mits	mits	VGW
hoor	hoor	TSW
winnaarmentaliteit	winnaarmentaliteit	ZNW:EKV:DE_
gunningcriterium	gunningcriterium	ZNW:EKV:HET
Gmail	Gmail	ENM:PRD
Valenciaans	Valenciaans	ZNW:EKV:HET
hozer	hozer	ZNW:EKV:DE_
hoers	hozer	ZNW:MRV:DE_
wolbad	wolbad	ZNW:EKV:HET
verveine	verveine	ZNW:EKV:DE_
actiegerichter	actiegericht	BNW:VGR:ONV
actiegerichtere	actiegericht	BNW:VGR:VRB
hôteliers	hôtelier	ZNW:MRV:DE_
patron-cuisinier	patron-cuisinier	ZNW:EKV:DE_
vaders	vader	ZNW:BEZ
moeders	moeder	ZNW:BEZ
oma's	oma	ZNW:BEZ
opa's	opa	ZNW:BEZ
ooms	oom	ZNW:BEZ
tantes	tante	ZNW:BEZ
codium	codium	ZNW:EKV
voorhanden	voorhanden	BNW:STL:ONV
voorhanden	voorhanden	BNW:STL:VRB
schapenwollen	schapenwollen	BNW:STL:VRB
schuurpapieren	schuurpapieren	BNW:STF
patron-cuisiniers	patron-cuisinier	ZNW:MRV:DE_
mp3-spelertje	mp3-speler	ZNW:EKV:VRK:HET
mp3-spelertjes	mp3-speler	ZNW:MRV:VRK:DE_
hivgeïnfecteerd	hivgeïnfecteerd	BNW:STL:ONV
hivgeïnfecteerde	hivgeïnfecteerd	BNW:STL:VRB
hivgeïnfecteerde	hivgeïnfecteerde	ZNW:EKV:DE_
hivgeïnfecteerden	hivgeïnfecteerde	ZNW:MRV:DE_
fetcht	fetchen	WKW:TGW:3EP
profilen	profilen	WKW:TGW:INF
mindervalide	mindervalide	BNW:OVR:ONV
mindervalide	mindervalide	BNW:STL:VRB
overal	overal	BYW
gunningcriteria	gunningcriterium	ZNW:MRV:DE_
Roemeens	Roemeens	BNW:STL:ONV
Roemeense	Roemeens	BNW:STL:VRB
opschoningen	opschoning	ZNW:MRV:DE_
hammond	hammond	ZNW:EKV:DE_
guinea	guinea	ZNW:EKV:DE_
guineas	guinea	ZNW:MRV:DE_
ramie	ramie	ZNW:EKV:DE_
gesmoltenzoutreactor	gesmoltenzoutreactor	ZNW:EKV:DE_
gesmoltenzoutreactoren	gesmoltenzoutreactor	ZNW:MRV:DE_
zwartwaterkoorts	zwartwaterkoorts	ZNW:EKV:DE_
pika	pika	ZNW:EKV:DE_
meesten	meest	VNW:OBP:MRV
doelgroepgerichter	doelgroepgericht	BNW:VGR:ONV
connect	connecten	WKW:TGW:1EP
connecte	connecten	WKW:VLT:1EP
geconnect	connecten	WKW:VTD:ONV
connect	connecten	WKW:TGW:3EP
connecten	connecten	WKW:VLT:INF
watertroggen	watertrog	ZNW:MRV:DE_
socialezekerheidssystemen	socialezekerheidssysteem	ZNW:MRV:DE_
penisvergrotingsapparaten	penisvergrotingsapparaat	ZNW:MRV:DE_
helaas	helaas	TSW
risicolopende	risicolopend	BNW:STL:VRB
rietgedekte	rietgedekt	BNW:STL:VRB
tegenover	tegenover	VGW
midden	midden	BYW
midden	midden	VRZ
