# deleted postag entries
#-------------------------------------------------------------------------------
# Do not add words here, but report them to languagetool@taaltik.nl
#-------------------------------------------------------------------------------
achtmaal	achtmaal	ZNW:EKV:HET
bijkans	bijkans	ZNW:EKV:DE_
dankzij	dankzij	ZNW:EKV:DE_
driemaal	driemaal	ZNW:EKV:HET
drone	drone	ZNW:EKV
duizendmaal	duizendmaal	ZNW:EKV:HET
duizendmalen	duizendmaal	ZNW:MRV:DE_
elfmaal	elfmaal	ZNW:EKV:HET
erachter	erachter	ZNW:EKV
geblind	geblind	ZNW:EKV:HET
gisteravond	gisteravond	ZNW:EKV:DE_
gisterenmorgen	gisterenmorgen	ZNW:EKV:DE_
gistermorgen	gistermorgen	ZNW:EKV:DE_
helaas	helaas	ZNW:EKV:HET
hivgeïnfecteerde	hivgeïnfecteerde	BNW:STL:VRB
hivgeïnfecteerden	hivgeïnfecteerden	UNSPECIFIED
honderdmaal	honderdmaal	ZNW:EKV:HET
honderdmalen	honderdmaal	ZNW:MRV:DE_
ietwat	ietwat	ZNW:EKV
ja	ja	ZNW:EKV:HET
leverteen	leverteen	ZNW:EKV:DE_
liggende	liggende	ZNW:EKV
meestak	meestak	ZNW:EKV
meeste	meeste	ZNW:EKV
meesten	meeste	ZNW:MRV:DE_
moving	moving	ZNW:EKV
nee	nee	ZNW:EKV:HET
neetjes	nee	ZNW:MRV:VRK:DE_
negenmaal	negenmaal	ZNW:EKV:HET
och	och	ZNW:EKV
oftewel	oftewel	ZNW:EKV
rietgedekte	rietgedekte	ZNW:EKV
risicolopende	risicolopende	ZNW:EKV
sambel	sambel	ZNW:EKV
sorry	sorry	ZNW:EKV
sparrenhouten	sparrenhout	ZNW:MRV:DE_
tegelijkertijd	tegelijkertijd	ZNW:EKV:DE_
tegenover	tegenover	ZNW:EKV
tienmaal	tienmaal	ZNW:EKV:HET
tienmalen	tienmaal	ZNW:MRV:DE_
tussendoor	tussendoor	ZNW:EKV
twaalfmaal	twaalfmaal	ZNW:EKV:HET
tweemaal	tweemaal	ZNW:EKV:HET
tweemalen	tweemaal	ZNW:MRV:DE_
vanmorgen	vanmorgen	ZNW:EKV:DE_
viermaal	viermaal	ZNW:EKV:HET
vijfmaal	vijfmaal	ZNW:EKV:HET
volledig	volledigen	WKW:TGW:1EP
volledigde	volledigen	WKW:VLT:1EP
volledigden	volledigen	WKW:VLT:INF
volledige	volledigen	WKW:AWS
volledigen	volledigen	WKW:TGW:INF
volledigt	volledigen	WKW:TGW:3EP
vrijwel	vrijwel	ZNW:EKV
waarvoor	waarvoor	ZNW:EKV:DE_
wakkergeschud	wakkergeschud	ZNW:EKV:HET
zesmaal	zesmaal	ZNW:EKV:HET
zesmalen	zesmaal	ZNW:MRV:DE_
zevenmaal	zevenmaal	ZNW:EKV:HET
zoiets	zoiets	ZNW:EKV:HET
vanmorgens	vanmorgen	ZNW:MRV:DE_
viermalen	viermaal	ZNW:MRV:DE_
Boris	Boris	ENM:LOC:PTS
aftar	aftarren	WKW:TGW:1EP
tarre	aftarren	WKW:AWS:LOS
Robbert	Robbert	UNSPECIFIED
hôtelier	hôtelier	UNSPECIFIED
palmblaren	palmblaren	ZNW:MRV:DE_
hôteliers	hôteliers	UNSPECIFIED
brugslag	brugslag	ZNW:EKV
socialezekerheidssystemen	socialezekerheidssystemen	ZNW:MRV:DE_
Robbert	Robbert	ENM:PER:LST:NIX
vanavonden	vanavond	ZNW:MRV:DE_
