# added postag entries
#-------------------------------------------------------------------------------
# Do not add words here, but report them to languagetool@taaltik.nl
#-------------------------------------------------------------------------------
aanren	aanrennen	WKW:TGW:1EP
aanrende	aanrennen	WKW:VLT:1EP
aanrenden	aanrennen	WKW:VLT:INF
aanrennend	aanrennen	WKW:ODW:ONV
aanrennende	aanrennen	WKW:ODW:VRB
aanrent	aanrennen	WKW:TGW:3EP
bijklusser	bijklusser	ZNW:EKV:DE_
laryngoscopie	laryngoscopie	ZNW:EKV:DE_
aanliggenden	aanliggen	WKW:ODW:MRV:DE_
afdoenden	afdoen	WKW:ODW:MRV:DE_
België	België	ENM:LOC:LND
aanhard	aanharden	WKW:TGW:1EP
doorgestraalde	doorstralen	WKW:VTD:VRB
geboeden	boeën	WKW:VTD:ZNW:MRV:DE_
aantak	aantakken	WKW:TGW:1EP
Brazilië	Brazilië	ENM:LOC:LND
Hollywoodacteur	Hollywoodacteur	ZNW:EKV:DE_
Hollywoodacteurs	Hollywoodacteur	ZNW:MRV:DE_
geargwaand	argwanen	WKW:VTD:ONV
argwanenden	argwanen	WKW:ODW:MRV:DE_
argwaant	argwanen	WKW:TGW:3EP
betengelde	betengelen	WKW:VTD:VRB
gecatechiseerde	catechiseren	WKW:VTD:VRB
appicoontjes	appicoon	ZNW:MRV:VRK:DE_
na	na	VGW
na	na	VRZ
fantasmagorieën	fantasmagorie	ZNW:MRV:DE_
aangedragene	aandragen	WKW:VTD:ZNW:EKV
aangegrepene	aangrijpen	WKW:VTD:ZNW:EKV
aangelegene	aanliggen	WKW:VTD:ZNW:EKV
aanstiet	aanstoten	WKW:VLT:1EP
aanstiet	aanstoten	WKW:VLT:GIJ
aangetroffene	aantreffen	WKW:VTD:ZNW:EKV
achteraangegaan	achteraangaan	WKW:VTD:ONV
achtergaande	achtergaan	WKW:ODW:VRB
achternagaand	achternagaan	WKW:ODW:ONV
afgedaan	afdoen	WKW:VTD:ONV
afgedane	afdoen	WKW:VTD:VRB
afgeplozen	afpluizen	WKW:VTD:ONV
afgeplozen	afpluizen	WKW:VTD:VRB
afried	afraden	WKW:VLT:1EP
afrieden	afraden	WKW:VLT:INF
afschuiert	afschuieren	WKW:TGW:3EP
beluid	beluiden	WKW:TGW:1EP
beluid	beluiden	WKW:VTD:ONV
bematen	bemeten	WKW:VLT:INF
besnedenen	besnijden	WKW:VTD:ZNW:MRV:DE_
bestaand	bestaan	WKW:ODW:ONV
bestaande	bestaan	WKW:ODW:VRB
bestaanden	bestaan	WKW:ODW:MRV:DE_
bestane	bestaan	WKW:VTD:VRB
bevittende	bevitten	WKW:ODW:VRB
bevitten	bevitten	WKW:VLT:INF
bijgaand	bijgaan	WKW:ODW:ONV
bijgaande	bijgaan	WKW:ODW:VRB
bijgeblevene	bijblijven	WKW:VTD:ZNW:EKV
bijgelegene	bijliggen	WKW:VTD:ZNW:EKV
bijpluste	bijplussen	WKW:VLT:1EP
plust	bijplussen	WKW:VLT:1EP:LOS
bijwonnen	bijwinnen	WKW:VLT:INF
wonen	bijwinnen	WKW:VLT:INF:LOS
bijzagen	bijzien	WKW:VLT:INF
bijziende	bijzien	WKW:ODW:VRB
bijzaagt	bijzien	WKW:VLT:GIJ
bijzagen	bijzagen	WKW:TGW:INF
bijgezaagd	bijzagen	WKW:VTD:ONV
bijgezaagde	bijzagen	WKW:VTD:VRB
bijzaag	bijzagen	WKW:TGW:1EP
bijzaagt	bijzagen	WKW:TGW:3EP
binnenklommen	binnenklimmen	WKW:VLT:INF
bleitend	bleiten	WKW:ODW:ONV
bleitende	bleiten	WKW:ODW:VRB
bleit	bleiten	WKW:TGW:3EP
broesde	broezen	WKW:VLT:1EP
buitengaand	buitengaan	WKW:ODW:ONV
buitengaande	buitengaan	WKW:ODW:VRB
conceptualiseer	conceptualiseren	WKW:TGW:1EP
conceptualiseerde	conceptualiseren	WKW:VLT:1EP
geconceptualiseerd	conceptualiseren	WKW:VTD:ONV
conceptualiserend	conceptualiseren	WKW:ODW:ONV
conceptualiserende	conceptualiseren	WKW:ODW:VRB
conceptualiseert	conceptualiseren	WKW:TGW:3EP
geconceptualiseerde	conceptualiseren	WKW:VTD:VRB
connecteerde	connecteren	WKW:VLT:1EP
cyclocrossende	cyclocrossen	WKW:ODW:VRB
disharmonieert	disharmoniëren	WKW:TGW:3EP
doorbriefen	doorbriefen	WKW:TGW:INF
doorbrief	doorbriefen	WKW:TGW:1EP
doorbrieft	doorbriefen	WKW:TGW:3EP
doorbriefte	doorbriefen	WKW:VLT:1EP
doorbrieften	doorbriefen	WKW:VLT:INF
doorgebrieft	doorbriefen	WKW:VTD:ONV
doorbriefde	doorbriefen	WKW:VLT:1EP
doorgebriefd	doorbriefen	WKW:VTD:ONV
doorgebriefde	doorbriefen	WKW:VTD:VRB
doorgebladerd	doorbladeren	WKW:VTD:ONV
doorgebladerde	doorbladeren	WKW:VTD:VRB
doorgeboord	doorboren	WKW:VTD:ONV
doorgeboorde	doorboren	WKW:VTD:VRB
doorgedacht	doordenken	WKW:VTD:ONV
doorgedachte	doordenken	WKW:VTD:VRB
doorweekt	doorweken	WKW:VTD:ONV
doorweekte	doorweken	WKW:VTD:VRB
doorweekten	doorweken	WKW:VTD:ZNW:MRV:DE_
doorgroeven	doorgroeven	WKW:TGW:INF
doorgroef	doorgroeven	WKW:TGW:1EP
doorgroefd	doorgroeven	WKW:VTD:ONV
doorgroevende	doorgroeven	WKW:ODW:VRB
doorgroeft	doorgroeven	WKW:TGW:3EP
doorgroefde	doorgroeven	WKW:VTD:VRB
doorploegd	doorploegen	WKW:VTD:ONV
doorploegde	doorploegen	WKW:VTD:VRB
doorsnuffeld	doorsnuffelen	WKW:VTD:ONV
doorsnuffelde	doorsnuffelen	WKW:VTD:VRB
doorsnuffelden	doorsnuffelen	WKW:VTD:ZNW:MRV:DE_
doorstraald	doorstralen	WKW:VTD:ONV
doorstraalde	doorstralen	WKW:VTD:VRB
doorstraalden	doorstralen	WKW:VTD:ZNW:MRV:DE_
doorstroomd	doorstromen	WKW:VTD:ONV
doorstroomde	doorstromen	WKW:VTD:VRB
doorwoekerd	doorwoekeren	WKW:VTD:ONV
doorwoekerde	doorwoekeren	WKW:VTD:VRB
doorwoeld	doorwoelen	WKW:VTD:ONV
doorwoelde	doorwoelen	WKW:VTD:VRB
doorworsteld	doorworstelen	WKW:VTD:ONV
doorworstelde	doorworstelen	WKW:VTD:VRB
borst	bersten	WKW:VLT:1EP
aanbaden	aanbidden	WKW:VLT:INF
getegen	aantijgen	WKW:VTD:ONV:LOS
aantegen	aantijgen	WKW:VLT:INF
adieert	adiëren	WKW:TGW:3EP
adieerde	adiëren	WKW:VLT:1EP
stieten	stoten	WKW:VLT:INF
boet	boeën	WKW:TGW:3EP
connectten	connecten	WKW:VLT:INF
contingenteert	contingenteren	WKW:TGW:3EP
hielden	houden	WKW:VLT:INF
dichthielden	dichthouden	WKW:VLT:INF
disharmonieerde	disharmoniëren	WKW:VLT:1EP
briefden	briefen	WKW:VLT:INF
doorbriefden	doorbriefen	WKW:VLT:INF
gecrowdsourcet	crowdsourcen	WKW:VTD:ONV
gecrowdsourcete	crowdsourcen	WKW:VTD:VRB
afstieten	afstoten	WKW:VLT:INF
couchsurften	couchsurfen	WKW:VLT:INF
