# deleted postag entries
#-------------------------------------------------------------------------------
# Do not add words here, but report them to languagetool@taaltik.nl
#-------------------------------------------------------------------------------
acteuren	acteur	ZNW:MRV:DE_
afgepeuterde	afpeuteren	WKW:VTD:VRB
battertjes	batter	ZNW:MRV:VRK:DE_
bedervertjes	bederver	ZNW:MRV:VRK:DE_
beklijfden	beklijven	WKW:VTD:ZNW:MRV:DE_
bespijkerden	bespijkeren	WKW:VTD:ZNW:MRV:DE_
bijklusser	bijklusser	ZNW:EKV
bijwonen	bijwinnen	WKW:VLT:INF
bovistjes	bovist	ZNW:MRV:VRK:DE_
carbonen	carboon	ZNW:MRV:DE_
cataclysmes	cataclysme	ZNW:MRV:DE_
conceptualiseerde	conceptualiseerde	WKW:VLT:1EP
constituents	constituent	ZNW:MRV:DE_
cyclocros	cyclocrossen	WKW:TGW:1EP
cyclocrost	cyclocrossen	WKW:TGW:3EP
doorgeweekt	doorweken	WKW:VTD:ONV
doorgeweekte	doorweken	WKW:VTD:VRB
escapistje	escapist	ZNW:EKV:VRK:HET
espadrilletje	espadrille	ZNW:EKV:VRK:HET
fantasmagorieën	fantasmagorieën	UNSPECIFIED
gecauteriseerde	cauteriseren	WKW:VTD:VRB
geconceptualiseerd	geconceptualiseerd	WKW:VTD:ONV
gedispenseerden	dispenseren	WKW:VTD:ZNW:MRV:DE_
guitigheidje	guitigheid	ZNW:EKV:VRK:HET
hoekertje	hoeker	ZNW:EKV:VRK:HET
houwde	houwen	WKW:VLT:1EP
inswingertjes	inswinger	ZNW:MRV:VRK:DE_
knickerbockertjes	knickerbocker	ZNW:MRV:VRK:DE_
laryngoscopie	laryngoscopie	ZNW:EKV
marmietje	marmiet	ZNW:EKV:VRK:HET
merinoswollen	merinoswol	ZNW:MRV:DE_
morning-afterpillen	morning-afterpil	ZNW:MRV:DE_
potentiële	potentiële	ZNW:EKV
pyridinen	pyridine	ZNW:MRV:DE_
regelaren	regelaar	ZNW:MRV:DE_
rosmarijnen	rosmarijn	ZNW:MRV:DE_
saucisses	saucisse	ZNW:MRV:DE_
schaftten	schaffen	WKW:VLT:INF
schelfje	schelf	ZNW:EKV:VRK:HET
schelfjes	schelf	ZNW:MRV:VRK:DE_
solfertje	solfer	ZNW:EKV:VRK:HET
stiefzustertje	stiefzuster	ZNW:EKV:VRK:HET
telluria	tellurium	ZNW:MRV:DE_
telluriums	tellurium	ZNW:MRV:DE_
tetter	tetter	ZNW:EKV
tetters	tetter	ZNW:MRV:DE_
tettertje	tetter	ZNW:EKV:VRK:HET
tettertjes	tetter	ZNW:MRV:VRK:DE_
visiteuren	visiteur	ZNW:MRV:DE_
wankelinkje	wankeling	ZNW:EKV:VRK:HET
wurgertje	wurger	ZNW:EKV:VRK:HET
yttria	yttrium	ZNW:MRV:DE_
België	België	ENM:LOC:RGN
adiëert	adiëren	WKW:TGW:3EP
aangeplat	aanplanten	WKW:VTD:ONV
aanplatte	aanplanten	WKW:VLT:1EP
droogski	droogskiën	WKW:TGW:1EP
autodeel	autodelen	WKW:TGW:1EP
autodeelt	autodelen	WKW:TGW:3EP
autodelend	autodelen	WKW:ODW:ONV
autodelende	autodelen	WKW:ODW:VRB
teeg	aantijgen	WKW:VLT:1EP:LOS
stijfde	aanstijven	WKW:VLT:1EP:LOS
doorbladerden	doorbladeren	WKW:VTD:ZNW:MRV:DE_
afhouw	afhouwen	WKW:TGW:1EP
afhouwde	afhouwen	WKW:VLT:1EP
afhouwden	afhouwen	WKW:VLT:INF
afhouwend	afhouwen	WKW:ODW:ONV
afhouwende	afhouwen	WKW:ODW:VRB
buikspreek	buikspreken	WKW:TGW:1EP
buikspreekt	buikspreken	WKW:TGW:3EP
conceptualiseer	conceptualiseer	WKW:TGW:1EP
Klaartje	Klaartje	ZNW:EKV:VRK:HET
afgezweerd	afzweren	WKW:VTD:ONV
Brazilië	Brazilië	ENM:LOC:RGN
bijwonnen	bijwonnen	UNSPECIFIED
vervormertje	vervormer	ZNW:EKV:VRK:HET
geargwaand	argwanen	WKW:VTD:VRB
kwamt	komen	WKW:VLT:GIJ
stiet	stoten	WKW:VLT:GIJ
connecte	connecten	WKW:VLT:1EP
connecten	connecten	WKW:VLT:INF
krast	afkrassen	WKW:VLT:1EP:LOS
essayeert	essayeren	WKW:TGW:1EP
